мар. 04, 2023 2:20:17 PM HomeWork6.Maze main
INFO: Лабиринт
    -1    -1    -1    -1    -1    -1    -1    -1    -1    -1    -1    -1    -1    -1    -1
    -1     0     0     0    -1     0     0     0     0     0     0     0     0     0    -1
    -1     0     0     0     0     0     0    -1     0     0     0     0     0     0    -1
    -1     0     0     0    -1     0     0    -1     0     0     0     0     0     0    -1
    -1     0     0     0    -1     0    -1    -1    -1    -1     0     0     0     0    -1
    -1     0     0     0    -1     0    -1     0     0    -1     0     0     0     0    -1
    -1    -1    -1     0    -1     0    -1     0     0    -1     0     0     0     0    -1
    -1     0     0     0    -1     0    -1     0     0    -1    -1    -1     0     0    -1
    -1     0     0     0    -1     0     0     0     0    -1     0     0     0     0    -1
    -1     0     0     0    -1     0     0     0     0    -1     0     0     0     0    -1
    -1     0     0     0    -1    -1    -1    -1    -1    -1     0     0     0     0    -1
    -1     0     0     0     0     0     0     0     0     0     0     0     0     0    -1
    -1     0     0     0    -1    -1    -1    -1    -1    -1    -1     0     0     0    -1
    -1     0     0     0     0     0     0     0     0     0     0     0     0     0    -1
    -1    -1    -1    -1    -1    -1    -1    -1    -1    -1    -1    -1    -1    -1    -1




